000000000000000000000000000000000000000000000000
0SSSSSSSSSSSSSSSSSSSSSSSS0000000000000000000000F
0S000000000000000000000000000000000000000000000F
0S000000000000000000000000000000000000000000000F
0S000000000000000000000000000000000000000000000F
0S000000000000000000000000000000000000000000000F
0S000000000000000000000000000000000000000000000F
0S000000000000000000000000000000000000000000000F
0S000000000000000000000000000000000000000000000F
0S000000000000000000000000000000000000000000000F
0S00T000000000000000000000000000000000000000000F
0S000000000000000000000000000000000000000000000F
0S000000000000000000000000000000000000000000000F
0S000000000000000000000000000000000000000000000F
0S000000000000000000000000000000000000000000000F
0S000000000000000000000000000000000000000000000F
0S00T000000000000000000000000000000000000000000F
0S000000000000000000000000000000000000000000000F
0S000000000000000000000000000000000000000000000F
0S000000000000000000000000000000000000000000000F
0S000000000000000000000000000000000000000000000F
0S000000000000000000000000000000000000000000000F
0S00T000000000000000000000000000000000000000000F
0S000000000000000000000000000000000000000000000F
0S000000000000000000000000000000000000000000000F
0S000000000000000000000000000000000000000000000F
0S000000000000000000000000000000000000000000000F
PS000000000000000000000000000000000000000000000F
PS00T000000000000000000000000000000000000000000F
PS000000000000000000000000000000000000000000000F
PS000000000000000000000000000000000000000000000F
00000000000000000000000000000000000000000000000F
00000000000000000000000000000000000000000000000F
00000000000000000000000000000000000000000000000F
0000T000000000000000000000000000000000000000000F
PPPPPPPPPPPPPPPPPPPPPPPPPPPPPPPPPPPPPPPPPPPPPPPP