PPPPPPPPPP0000PPPPPPPPPPPPPPPPPPPPPPPPPPPPPPPPPP
P0000000000000P00000000000000000000000000000000P
P0000000000000P00000000000000000000000000000000P
PPPPPPP0000000P00PPPPPPPPPPPPPPPPP0000000PPPPPPP
P000000000000CP000000000000000000PC000000000000P
P0000000PPPPPPP000000000000000000PPPPPPP0000000P
P0000000000000P00PPPPPPPPPPPPPP00P0000000000000P
P0000000000000PSS00000000S0000000P0000000000000P
P0000000000000P0000000000S0000000P0000000000000P
P0000000000000P0000000000S000000PP0000000000000P
P0000000000000P000000PP00000PP000P0000000000000P
P000SSSSSSSSSSP000000000000000000PSSSSSSSSSS000P
P0000000000000P00P000000000000000P0000000000000P
P0000000000000P000000000000000000P0000000000000P
P0000000000000P0000000000P0000000P0000000000000P
P0000000000000P0000SSSSSSSSSSSSSSP0000000000000P
P0000000000000PP00PPPPPPPPPPPPPPPP0000000000000P
P0000000000000P000000000000000000P0000000000000P
P0000000000000P000000000000000000P0000000000000P
P0000000000000PPPPPPPPPPPPPPPP00PP0000000000000P
P00000000SSSSSPSSSSSSSSSSSSSS0000PSSSSS00000000P
P0000000000000P0000000P0000000000P0000000000000P
PSSSSS00000000P000000000000000000P00000000SSSSSP
P0000000000000P000000000000000P00P0000000000000P
P0000000000000P000000000000000000P0000000000000P
P0000000000000P000PP00000PP000000P0000000000000P
P0000000000000PP000000S0000000000P0000000000000P
P0000000000000P0000000S0000000000P0000000000000P
P0000000000000P0000000S00000000SSP0000000000000P
P0000000000000P00PPPPPPPPPPPPPP00P0000000000000P
P0000000000000P000000000000000000P0000000000000P
P0000000000000PC00000000000000000P0000000000000P
PSSSSSSSSSS000PPPPPPPPPPPPPPPPP00P000SSSSSSSSSSP
P00000000000000000000000000000000P0000000000000P
P00000000000000000000000000000000P0000000000000P
PPPPPPPPPPPPPPPPPPPPPPPPPPPPPPPPPP0000PPPPPPPPPP