PPPPPPPPPPPPPPPPPPPPPPPPPPPPPPPPPPPPPPPPPPPPPPPP
P0000000000000000000000000000000000000000000000P
P0000000000000000000000000000000000000000000000P
P000000000000000PPPPPPPPPPPPPPPPPPPPPPPPPPP0000P
P000000000000000SP000000000000S00000SPS00000000P
P00000000000000S0P000000000000S00000SPS00000000P
P0000000000000S00P000000000000S00000SPS00000000P
P00000000000PS000P000000000000S00000SPSS000000SP
P00000000000S0000PSSS000SSP000S00000SPS00000000P
P0000000000S00000P00000000P000000000SPS00000000P
P000000000S000000P00000000PP0000PP00SPS00000000P
P0000000PS0000000P00000000P000000000SPS00000000P
PP0S00PPPPPPPPPPPPSS000SSSP000000000SPSSS0000SSP
P00S0000000000000P00000000P000000000SPS00000000P
P00S0000000000000P00000000P00000000PSPS00000000P
P00S0000000000000P00000000P000000000SPS00000000P
PP0S0000000000000PS000SSSSP000000000SPS00000000P
P0000000000000000P00000000P000000000SPSSSS00SSSP
P00000S0000000000P00000000P00000PP00SPS00000000P
PC0000S0000000000P00000000P000000000SPS00000000P
PPPPPPSPP00000000P000SSSSSP000000000SPS00000000P
P00000S0000000000P00000000P000000000SPS00000000P
P00000S0000000000P00000000P00000000PSPSSS0000SSP
P00P00000PP000000P00000000P000000000SPS00000000P
P0000000000000000PS000SSSSP000000000SPS00000000P
P0000000000000000P00000000P000000000SPS00000000P
P0000000000000000P00000000P00000PP00SPS00000000P
PP000000000000000P00000000P000000000SPSS000000SP
P0000000000000000PSS000SSSP000000000SPS00000000P
P0000000000000000P00000000P000000000SPS00000000P
P0000000000000000P00000000P0PP000000SPS000SSSSSP
000P0000000000000P00000000P000000000000000S0000P
00000000000000000PSSS000SSP000000000000000S0000P
00000000000000000P00000000P000000000000000S0000P
00000000000000000P00000000PPC0000000000000S0000P
PPPPPPPPPPPPPPPPPPSSS00000PPPPPPPPPPPPPPPPPPPPPP