000000000000000000000000000000000000000000P0000P
000000000000000000000000000000000000000000P0000P
000000000000000000000000000000000000000000P0000P
000000000000000000000000000000000000000000P0000P
000000000000000000000000000000000000000000P0000P
000000000000000000000000000000000000000000P0000P
000000000000000000000000000000000000000000P0000P
0000000000000000000000000000PPPPPPPPPPPPPPP0000P
0000000000000000000000000000P000SSSS00SSSS00000P
0000000000000000000000000000P000000000000000000P
0000000000000000000000000000P000000000000000000P
0000000000000000000000000000P000000000000000000P
0000000000000000000000000000P000000000000000000P
0000000000000000000000000000P0000T000000T000000P
0000000000000000000000000000P0000SSSSSSSSSSSSSTP
0000000000000000000000000000P00SSPPPPPPPPPPPPPPP
0000000000000000000000000000P0000P00000000000000
0000000000000000000000000000P0000P00000000000000
0000000000000000000000000000P0000P00000000000000
0000000000000000000000000000PSS00P00000000000000
0000000000000000000000000000P0000P00000000000000
0000000000000000000000000000P0000P00000000000000
0000000000000000000000000000P0000P00000000000000
0000000000000000000000000000P00SSP00000000000000
0000000000000000000000000000P0000P00000000000000
0000000000000000000000000000P0000P00000000000000
0000000000000000000000000000P0000P00000000000000
0000000000000000000000000000P0000P00000000000000
0000000000000000000000000000P0000P00000000000000
0000000000000000000000000000P0000P00000000000000
0000000000000000000000000000P0000P00000000000000
0000000000000000000000000000PS00SP00000000000000
0000000000000000000000000000P0000P00000000000000
0000000000000000000000000000P0000P00000000000000
0000000000000000000000000000P0000P00000000000000
0000000000000000000000000000P0000P00000000000000