PPPPPPPPPPPPPP0000000000000000000000000000000000
0000000000000P0000000000000000000000000000000000
0000000000000P0000000000000000000000000000000000
0000000000000P0000000000000000000000000000000000
00000000SS000P0000000000000000000000000000000000
PPPPPPPPPP000P0000000000000000000000000000000000
000000P000000P0000000000000000000000000000000000
000000P000000P0000000000000000000000000000000000
000000P000000P0000000000000000000000000000000000
000000P00S000P0000000000000000000000000000000000
PSSTTSP00S000P0000000000000000000000000000000000
P00000P00S0T0P0000000000000000000000000000000000
P00000P00SSSSP0000000000000000000000000000000000
P00000P000000P0000000000000000000000000000000000
PSSSTTP000000P0000000000000000000000000000000000
P00000P000000P0000000000000000000000000000000000
P00000P000000P0000000000000000000000000000000000
P00000P000S00P0000000000000000000000000000000000
PSSTTSP000S00P0000000000000000000000000000000000
P00000P0T0S00P0000000000000000000000000000000000
P00000PSSSS00P0000000000000000000000000000000000
P00000P000000P0000000000000000000000000000000000
PSTTSSP000000P0000000000000000000000000000000000
P00000P000000P0000000000000000000000000000000000
P00000P000000P0000000000000000000000000000000000
P00000P00S000P0000000000000000000000000000000000
PTTSSSP00S000P0000000000000000000000000000000000
P00000P00S0T0P0000000000000000000000000000000000
P00000P00SSSSP0000000000000000000000000000000000
P00000P000000P0000000000000000000000000000000000
PSTTSSP000000P0000000000000000000000000000000000
P00000PT00000P0000000000000000000000000000000000
P000000000000P0000000000000000000000000000000000
P000000000000P0000000000000000000000000000000000
P000000C00000P0000000000000000000000000000000000
PPPPPPPPPPPPPP0000000000000000000000000000000000