PPPPPPPPPPPPPPPPPPPPPPPPPPPPPPPPPPPPPPPPPPPPPPPP
PSSSSSSSSSSSSSSSSSSSSSSSSSSSSSSSSSSSSSSSSSSSSSSP
PS00PP00000000000000000000000000000000000000000P
PS000000000000000000000000000000000000000000000P
PS00000000000000000000000000000000000000000000FP
PS000000PP0000000000000000000000000000000000000P
PS000000000000000000000000000000000000000000000P
PS00000000000000000000000000000000000000000000FP
PS00PP00000000000000000000000000000000000000000P
PS000000000000000000000000000000000000000000000P
PS00000000000000000000000000000000000000000000FP
PS000000PP0000000000000000000000000000000000000P
PS000000000000000000000000000000000000000000000P
PS00000000000000000000000000000000000000000000FP
PS00PP00000000000000000000000000000000000000000P
PS000000000000000000000000000000000000000000000P
PS00000000000000000000000000000000000000000000FP
PS000000PP0000000000000000000000000000000000000P
PS000000000000000000000000000000000000000000000P
PS00000000000000000000000000000000000000000000FP
PS00PP00000000000000000000000000000000000000000P
PS000000000000000000000000000000000000000000000P
PS00000000000000000000000000000000000000000000FP
PS000000PP0000000000000000000000000000000000000P
PS000000000000000000000000000000000000000000000P
PS00000000000000000000000000000000000000000000FP
PS00PP00000000000000000000000000000000000000000P
PS000000000000000000000000000000000000000000000P
PS00000000000000000000000000000000000000000000FP
PS000000PP0000000000000000000000000000000000000P
PS000000000000000000000000000000000000000000000P
0000000000000000000000000000000000000000000000F0
0000PP000000000000000000000000000000000000000000
000000000000000000000000000000000000000000000000
0000000000000000000000000000000000000000000000F0
PPPPPPPPPPPPPPPPPPPPPPPPPPPPPPPPPPPPPPPPPPPPPPPP