P00000PPPPPPPPPPPPPPPPPPPPPPPPPPPPPPPPPPPPPPPPPP
P00000P0000000000000000000000000000000000000000P
P00000P0000000000000000000000000000000000000000P
P00000P000PPPPPPPPPPPPPPPPPPPPPPPPPPPPPPPPPPPP0P
P00000P0000000SP0000000000000000000000000000000P
P00000PPP00000SP0000000000000000000000000000000P
P00000P0000000SP0000000000000000000000000000000P
P00000P0000000SP0000000000000000000000000000000P
P00000P00PP000SP0000000000000000000000000000000P
P00000P0000000SPPPPPPPPPPPPS000000SPPPPPPPPPPPPP
P00000P0000000SP0000000000000000000000000000000P
P00000P0000PP0SP0000000000000000000000000000000P
P00000P0000000SP0000000000000000000000000000000P
P00000P0000000SP0000000000000000000000000000000P
P00000P00PP000SP00SPPPPPPPPPPPPPPPPPPPPPPPPPS0SP
P00000P0000000SP00000000000S00000000000SSSSSS0SP
P00000P0000000SP0000000000000000000000000000000P
P00000PPP00000SP0000000000000000000000000000000P
P00000P0000000SP0000000000000000000000000000000P
P00000P0000000SP000000S000000000SS0000000000000P
P00000P00PP000SPPPPPPPPPPPPPPPPPPPPPPPPPPPPPPP0P
P00000P0000000SP0000000000000000000000000000000P
P00000P0000000SP0000000000000000000000000000000P
P00000P0000PP0SP0000000000000000000000000000000P
P0000000000000SP0000S00000000000000000000S00000P
PS00C000000000SP0000S00000000000000000000S000C0P
PPPPPPPPPPPPPPPP0000PPPPPPPPPPPPPPPPPPPPPPPPPPPP
000000000000000P0000S00000000000000000000S00000P
000000000000000P0000S00000000000000000000S00000P
000000000000000P0000S00000000000000000000S00000P
000000000000000P0000S00000000000000000000S00000P
000000000000000P0000S00000000000000000000S000000
000000000000000P0000S00000000000000000000S000000
000000000000000P00000000000000000000000000000000
000000000000000P00000000000000SS0000000000000C00
000000000000000PPPPPPPPPPPPPPPPPPPPPPPPPPPPPPPPP