P00000000000000000000000000000000000000000000000
P00000000000000000000000000000000000000000000000
P00000000000000000000000000000000000000000000000
P00000000000000000000000000000000000000000000000
P00000000000000000000000000SSSSSSSSSSSSSS0000000
P000000000000000000000S0000PPPPPPPPPPPPPS0000000
P0000000000000T000000SPS000SSSSSSSSSSSSPS0000000
P00000000000000000000SPS000S000S000000SPS0000000
P00000000000000000000SPS000S000S000000SPS0000000
P00000000000000000000SPS000S000S000000SPS0000000
P00000000000000000000SPS000S0000000000SPS0000000
P0000000000T000000000SPS000S0000000000SPS0000000
P00000000000000000000SPS000S0000000000SPS0000000
P00000000000000000000SPS0000000000SS00SPS0000000
P000PP00000000T0PP000SPS00000000000S00SPS0000000
P000PS000SSSS0000P000SPS000000000T0S00SPS0000000
P000PS000S00S0000P000SPS000000SS000S00SPS0000000
P000PS000S00S0000P000SPS0000000S000S00SPS0000000
P000PS000S000000TP000SPS00000T0SSSSS00SPS0000000
P000PS00000000000P000SPS00SS000SPPPP00SPS0000000
P000PS00000000000P000SPS000S000SP00000SPS0000000
P0S0PS000000S000CP000SPS0T0SSSSSP0000SSPS0000000
PPPPPP000S00S000PP000SPS000SPPPPP000SSPPSPPPPPPP
P00000000S00S0000S000SPS000SP000000000000000000P
P000000T0SSSS0T00S000SPSSSSSP000000000000000000P
P0000PPPPPPPPPPPPPPPPPPPPPPPPPPPPPPPPPPPPPP0000P
P000PPS00000000000000000000000000S000S000000000P
P0000PS000TTTTTTTTTTTTTTT0000000000000000000000P
P0000PS000SSSSSSSSSSSSSSS0000000000000000000000P
P0000PS000PPPPPPPPPPPPPPS000000S000S000S000000CP
PP000PS000SSSSSSSSSSSSSPPPPPPPPPPPPPPPPPPPPPPPPP
00000PS0000000000000000000000000000000000000000P
00000PS0000000000000000000000000000000000000000P
00000PS0000000000000000000000000000000000000000P
0000PPSSSS0000000000000S00000000000000000000000P
PPPPPPPPPPPPPPPPPPPPPPPPPPPPPPPPPPPPPPPPPPP0000P