PPPPPPPPPPPPPPPPPPPPPPPPPPPPPPPPPPPPPPPPPPPPPPPP
0000000000000000000000000000000P0000000000000000
0000000000000000000000000000000P0000000000000000
0000000000000000000000000000000P0000000000000000
000000000000000000000SS00000000P0000000000000000
PPPPPPPPPPPPP0000000SPPS0000000P000PPPPPPPPPPPPP
P00000000000P00000000SS00000000P0T0P000000000000
P00000000000P000000000000000000P000P000000000000
P00000000000P000000000000000000P000P000000000000
P00000000000P000000000000000000P000P000000000000
P00000000000P000000000000000000P0T0P0PPPPPS000SP
P00000000000P000000000000000000P000P0000000S0S0P
P00000000000P000000000000000000P000P00000000T00P
P00000000000P000000000000000000P000P00000000000P
P0P000000000P000000000000000000P0T0P00000000000P
P0S000000000P000000000000000000P000P00000000000P
P0S000000000P000000000000000000P000PTSSSSSS0000P
P0S000000000P000000000000000000P000P00000000000P
P0SP00000000P000000000000000000P0T0P00000000000P
P0S000000000P000000000000000000P000P00000000000P
P0S000000000P000000000000000000P000P00000000000P
P0S000000000P000000000000000000P000P0PPPPPS000SP
P0S0P0000000P000000000000000000P0T0P0000000S0S0P
P0S000000000P000000000000000000P000P00000000T00P
P0S000000000P000000000000000000P000P00000000000P
P0S000000000P000000000000000000P000P00000000000P
P0S00P000000P000000000000000000P0T0P00000000000P
P0S000000000P0000000000000000000000PTSSSSSS0000P
P0S000000000PC000000000000000000000P00000000000P
P0S000000000PPPPPPPPPPPPPPPPPPPPPPPP00000000000P
P0S000P0000000000000000000000000000000000000000P
00S00000000000000000000000000000000000000000000P
00S00000T00000000000000000000000000000000000000P
00S00000000000000000000000000000000000000000000P
00SSSSSSSSSTTSTTSTTSTTSTTSTTSTTSTTSTS000000000CP
PPPPPPPPPPPPPPPPPPPPPPPPPPPPPPPPPPPPPPPPPPPPPPPP