PPPPPPPPPPPPPPPPPPPPPPPPPPPPPPPPPPPPPPPPPPPPPPPP
P0000000000000000000000000000000000000000000000P
P0000000000000000000000000000000000000000000000P
P0000000000000000000000000000000000000000000000P
P0000000000000000000000000000000000000000000000P
P0000000000000000000000000000000000000000000000P
P0000000000000000000000000000000000000000000000P
P0000000000000000000000000000000000000000000000P
P0000000000000000000000000000000000000000000000P
P0000000000000000000000000000000000000000000000P
P0000000000000000000000000000000000000000000000P
P0000000000000000000000000000000000000000000000P
P0000000000000000000000000000000000000000000000P
P0000000000000000000000000000000000000000000000P
P0000000000000000000000000000000000000000000000P
P0000000000000000000000000000000000000000000000P
P0000000000000000000000000000000000000000000000P
P0000000000000000000000000000000000000000000000P
P0000000000000000000000000000000000000000000000P
P0000000000000000000000000000000000000000000000P
P0000000000000000000000000000000000000000000000P
P0000000000000000000000000000000000000000000000P
P0000000000000000000000000000000000000000000000P
P00PP00P000000000000000000000000000000000000000P
P000P00PP00000000000000000000000000000000000000P
P000P00P0P0000000000000000000000000000000000000P
P000P00P00P000000000000000000000000000000000000P
PP00P00P000P00000000000000000000000000000000000P
P000P00P0000P0000000000000000000000000000000000P
P000P00P00000PSSSSSSSSSSSSSSSSSSSSSSSSSSSSSSSSSP
P000P00PPPPPPPPPPPPPPPPPPPPPPPPPPPPPPPPPPPPPPPPP
P00PP00SSSSSSSSSSSSSSSSSSSSSSSSSSSSSSSSSSSP00000
P000P0000000000000000000000000000000000000000000
P000P0000000000000000000000000000000000000000000
P000PC000000000000000000000000000000000000000000
PPPPPPPPPPPPPPPPPPPPPPPPPPPPPPPPPPPPPPPPPPPPPPPP