00000000000000000P00S00000PPPPPPPPPPPPPPPPPPPPPP
00000000000000000P00S00000PS000000000S0000000000
00000000000000000P00S00000PS000000000S0000000000
00000000000000000P00S00000PS000000000S0000000000
00000000000000000P00S00000PS000000000S0000000000
00000000000000000P00SSSSSSPS000000000S00P00P00PP
00000000000000000P00000000PS0000S0000S000000000P
00000000000000000P00000000PS0P00S00SSS000000000P
00000000000000000P00000000PS0000S0000S000000000P
00000000000000000P00000000PS0000S0000S00P00P00PP
00000000000000000P00000000PS0000S0000S000000000P
00000000000000000P00S00S00PS00P0S0000S000000000P
00000000000000000PSSS00SSSPS0000S0000S0P00P00P0P
00000000000000000P00000000PS0000SSS00S000000000P
00000000000000000P00000000PS0000S0000S000000000P
00000000000000000P000S00S0PS00P0S0000SP00P00P00P
00000000000000000PSSSS00SSPS0000S0000S000000000P
00000000000000000P00000000PS0000S0000S000000000P
00000000000000000P00000000PS0000S0000S0P00P00P0P
00000000000000000P00000000PS0P00S00SSS000000000P
00000000000000000P00000000PS0000S0000S000000000P
00000000000000000P00SSSSSSPS0000S0000S00P00P00PP
00000000000000000P00S00000PS0000S0000S000000000P
00000000000000000P00S00000PS00P0SSS00S000000000P
00000000000000000P00S00000PS0000S0000S0P00P00P0P
00000000000000000P00S00000PS0000S0000S000000000P
00000000000000000P00S00000PS0000S0000S000000000P
00000000000000000P00SSSSSSPS0P00S00SSSP00P00P00P
00000000000000000P00000000000000S00000000000000P
00000000000000000PC0000000000000S0000000000000CP
PPPPPPPPPPPPPPPPPPPPPPPPPPPPPPPPPPPPPPPPPPPPPPPP
000000000000000000000000000000000000000000000000
000000000000000000000000000000000000000000000000
000000000000000000000000000000000000000000000000
0000000000000000STTS00000000000STTS0000000000000
PPPPPPPPPPPPPPPPPPPPPPPPPPPPPPPPPPPPPPPPPPPPPPPP