00000000000000000000000PPPPPPPPPPPPPPPPPPPP0000P
00000000000000000000000PS00SSSS00SSSS00SSSS0000P
00000000000000000000000P00000000000000000000000P
00000000000000000000000P00000000000000000000000P
00000000000000000000000P00000000000000000000000P
00000000000000000000000P00000000000000000000000P
00000000000000000000000P0SSSTTSSSSTTSSSSTTSSTTSP
00000000000000000000000P0P000000000000000000000P
00000000000000000000000P00000000000000000000000P
00000000000000000000000PC0000000000000000000000P
00000000000000000000000PPP000000000000000000000P
00000000000000000000000P0S00S000000000000000000P
00000000000000000000000P0S00S000000000000000000P
00000000000000000000000P0STTS0000000000STTSSSS0P
00000000000000000000000P00000S000000000S0000000P
00000000000000000000000P00000S000000000S0000000P
00000000000000000000000P000000S00S00STTS00PPPPPP
00000000000000000000000P0PPP00S00S00S00000PSSSSP
00000000000000000000000P00SP00STTSTTS00000P000SP
00000000000000000000000P00SP00000000000PPPP000SP
00000000000000000000000P00SPC0000000000P000000SP
00000000000000000000000PS0SPPPPPPPPPPPPP000000SP
00000000000000000000000PS0P0000000000000000000SP
00000000000000000000000PS0P00000000000000000000P
00000000000000000000000PS0P00000000000000000000P
00000000000000000000000PS0P0000000000000000SP00P
00000000000000000000000PS0P0000000000000000SP00P
00000000000000000000000PS0P0000000000000000SP00P
00000000000000000000000PS0P00000000T0000000SP00P
00000000000000000000000PS0P0000000000000000SP00P
00000000000000000000000PS0P0000000000000000SP00P
00000000000000000000000PS0P00000T0000000000SP000
00000000000000000000000PS0P0000000000000000SP000
00000000000000000000000PS000000000000000000SP000
00000000000000000000000PS0000TSSSSSSSSSSSSSSP000
00000000000000000000000PPPPPPPPPPPPPPPPPPPPPPPPP