PPPPPPPPPPPPPPPPPPPPPPPPPPPPPPPPPPPPPPPPPPPPPPPP
00000000000000000000000000000000000000000000000P
00000000000000000000000000000000000000000000000P
00000000000000000000000000000000000000000000000P
00000000000000000000000000000000000000000C00000P
PPPPPPPPPPPPPPPPPPPPPPPPPPPPPPPPPPPPPPPPPPP000SP
PSSSSSSSSSSSSSSSSSSSSSSSSSSSSSSSSSSSSSSSSSS000SP
PS0000000000000000000000000000000S000000000000SP
PS0000000000000000000000000000000S000000000000SP
PS00000000000000000000000000000000000000000000SP
PS00000000000000000000P000P0000000000PP0000000SP
PS0000000000000000000PP00000000000000000000000SP
PS00000000000000000000000000000000000000000000SP
PS000000000000000000000000000PP000000000000000SP
PS000000000PP000000000000000000000000000000000SP
PS0000000000P000000000000000000000000000000000SP
PS00000000000000000000000000000000000000000000SP
PS000SSSSSSSSSSSSSSSSSSSSSSSSSSSSSSSSSSSSSSSSSSP
PS000PPPPPPPPPPPPPPPPPPPPPPPPPPPPPPPPPPPPPPPPPPP
PS000PSSSSSSSSSSSSSSSSSSSSSSSSSSSSSSSSSSSSSSSSSP
PS000P00000000000000000000000000000000000000000P
PS000P00000000000000000000000000000000000000000P
PS000P00000000000000000000000000000000000000000P
PS000P00000000PPP0000000PPP0000000PPP0000000000P
PS000P00000000000000000000000000000000000000000P
PS000P000PPP0000000PPP0000000PPP0000000PPP00000P
PS000P00000000000000000000000000000000000000000P
PS000P00000000000000000000000000000000000000000P
PS000PP0000000000000000000000000000000000000000P
PS000P0000SSSSSSSSSSSSSSSSSSSSSSSSSSSSSSSSS0000P
PS000P0000PPPPPPPPPPPPPPPPPPPPPPPPPPPPPPPPP0000P
PS0000000PP0000000000000000000000000000000P00000
PS00000000P0000000000000000000000000000000P00000
PS00000000P0000000000000000000000000000000P00000
PS0000000CP0000000000000000000000000000000P00000
PPPPPPPPPPP0000000000000000000000000000000PPPPPP