000000000000000000000000000PP0000PPPPPPPPPPPPPPP
000000000000000000000000000PS0000SP000000000000P
000000000000000000000000000PS0000SPTTTTTTTTTTT0P
000000000000000000000000000PS0000SP0SSSSSSSSSS0P
000000000000000000000000000PS0000SP0S00000000S0P
000000000000000000000000000PS0000SPTS00000000S0P
000000000000000000000000000PS0000SP0S00000000S0P
000000000000000000000000000PS0000SP0S00000000S0P
000000000000000000000000000PS0000SP0S00000000S0P
000000000000000000000000000PS0000SP0S00000000S0P
000000000000000000000000000PS0000SPTS00000000S0P
000000000000000000000000000PS0000SP0S00000000S0P
000000000000000000000000000PS0000SP0S00000000S0P
000000000000000000000000000PS0000SP0S00000000S0P
000000000000000000000000000PS0000SP0S00000000S0P
000000000000000000000000000PS0000SPTS00000000S0P
000000000000000000000000000PS0000SP0S00000000S0P
000000000000000000000000000PS0000SP0S00000000S0P
000000000000000000000000000PS0000SP0S00000000S0P
000000000000000000000000000PS0000SP0S00000000S0P
000000000000000000000000000PS0000SPTS00000000S0P
000000000000000000000000000PS0000SP0S00000000S0P
000000000000000000000000000PS0000SP0S00000000S0P
000000000000000000000000000PS0000SP0S00000000S0P
000000000000000000000000000PS0000SP0S00000000S0P
000000000000000000000000000PS0000SPTS00000000S0P
000000000000000000000000000PS0000SP0S00000000S0P
000000000000000000000000000PS0000SP0S00000000S0P
000000000000000000000000000PS0000SP0S00000000S0P
000000000000000000000000000PS0000SP0S00000000S0P
000000000000000000000000000PS0000SPTS00000000S0P
000000000000000000000000000P00000000S00000000S00
00000000000000000000000000PP00000000S00000000S00
00000000000000000000000000P000000000S00000000S00
00000000000000000000000000P000000000S00000000S00
00000000000000000000000000PPPPPPPPPPPPPPPPPPPPPP