PPPPPPPPPPPPPPPPPPPPPPPPPPPPPPPPPPPPPPPPPPPPPPPP
P00000000000SP000000000000000000000000SS000SP000
P00000000000SP000000000000000000000000000000P000
P00000000000SP00PPPPPPPPPPPPPPPPP00000000000P000
P00000000000SP000000000000000000000000000000P000
P00000000000SP000000000000000000000000000000P0PP
PP0000000000SPPPPP00000000000000000000000000P00P
P00000000000SP0000000000000000PSP00PPP00PPP0P00P
P00000000000SP00000000000000000SP00000000000P0PP
P00000000000SP00000000000000000SP00000000000P00P
PP0000000000SP0PP00PP0000000000SP00000000000P00P
P0000S000000SP0000000000000000PSP00000000000P0PP
P000SPS00000SP00000000000000000SP00000000000P00P
P000SPS00000SP00000000000000000SP00000000000P00P
PP00SPS00000SPP0000000000000000SP00000000000P0PP
P000SPS00000SP00000000000P000P0SP00000000000P00P
P000SPS00000SP00000000000000000SP00000000000P00P
P000SPS00000SP00000000000000000SPSS000SS000SP00P
PP00SPS00000SP0PP00000000000000SPPP000PP000PP0PP
P000SPS00000SP000000000PP000000SP0000000000SP00P
P000SPS00000SP00000000000000000SP0000000000SP00P
P000SPS00000SP0000PP00000000000SP0000000000SP00P
PP00SPS00000SP000000000000PP000SP0000000000SP0PP
P000SPS000000000000000000000000SP0000000000SP00P
P0000S0000000000000000000000000SP00000000000P00P
P00000000PPPP00000000000PP00000SP00000000000P00P
PP0000000SSSP000000000000000000SP00000000000P0PP
P0000000000SP000000000000000000SP00000000000000P
P0000000000SP000000000000000PP0SP00000000000000P
P0000000000SP0000C0000000000000SP00SSS00SSS00C0P
PPPPP0000PPPPPPPPPPPPPPPPPPPPPPPPPPPPPPPPPPPPPPP
SSSSS0000P00000000000000000000000000000000000000
000000000P00000000000000000000000000000000000000
000000000P00000000000000000000000000000000000000
000000C0PP00000000000000000000000000000000000000
PPPPPPPPPP0000PPPPPPPPPPPPPPPPPPPPPPPPPPPPPPPPPP