PPPPPPPPPPPPPPPPPPPPPPPPPPPPPPPPPPPPPPPPPPPPPPPP
P0000000000000000000000000000000000000000000000P
P0000000000000000000000000000000000000000000000P
P0000000000000000000000000000000000000000000000P
P0000000000000000000000000000000000000000000000P
P0000000000000000000000000000000000000000000000P
P0000000000000000000000000000000000000000000000P
P0000000000000000000000000000000000000000000000P
P0000000000000000000000000000000000000000000000P
P0000000000000000000000000000000000000000000000P
PPPPPPPPPPPPPPPPPPPPPPPPPPPPPPPPPPPPPPPPPPP0000P
P0000000000000000000000P00000000000000000000000P
P0000000000000000000000P00000000000000000000000P
P0000000000000000000000P00000000000000000000000P
P0000000000000000000000000000000000000000000000P
P0000000000000000000000000000000000000000000000P
P0000000000000000000000000000000000000000000000P
P0000000000000000P00000000000P00000000000000000P
P0000000000000000P00000000000P00000000000000000P
P0000000000000000P00000000000P00000000000000000P
P0000PPPPPPPPPPPPPPPPPPPPPPPPPPPPPPPPPPPPPPPPPPP
P0000000000000000000000000000000000000000000000P
P0000000000000000000000000000000000000000000000P
P0000000000000000000000000000000000000000000000P
P0000000000000000000000000000000000000000000000P
P0000000000000000000000000000000000000000000000P
P0000000000000000000000000000000000000000000000P
P0000000000000000000000000000000000000000000000P
P0000000000000000000000000000000000000000000000P
P0000000000000000S00000000000S00000000000000000P
PPPPPPPPPPPPPPPPPPPPPPPPPPPPPPPPPPPPPPPPPPP0000P
P0000000000000000000000000000000000000000000000P
P0000000000000000000000000000000000000000000000P
P0000000000000000000000000000000000000000000000P
P0000000000000000000000C00000000000000000000000P
P00000PPPPPPPPPPPPPPPPPPPPPPPPPPPPPPPPPPPPPPPPPP

48x36