PPPPPPPPPPPPPPPPPPPPPPPPPPPPPPPPPPPPPPPPPPPPPPPP
00000000000000000000000000000000000000000000000P
00000000000000000000000000000000000000000000000P
00000000000000000000000000000000000000000000000P
00000000000000000000000000000000000000000000000P
P0000000000000000000000000000000000000000000000P
P0000000000000000000000000000000000000000000000P
P0000000000000000000000000000000000000000000000P
P0000000000000000000000000000000000000000000000P
P0000000000000000000000000000000000000000000000P
P0000000000000000000000000000000000000000000000P
P0000000000000000000000000000000000000000000000P
P0000000000000000000000000000000000000000000000P
P0000000000000000000000000000000000000000000000P
P0000000000000000000000000000000000000000000000P
P0000000000000000000000000000000000000000000000P
P0000000000000000000000000000000000000000000000P
P0000000000000000000000000000000000000000000000P
P0000000000000000000000000000000000000000000000P
P0000000000000000000000000000000000000000000000P
P0000000000000000000000000000000000000000000000P
P0000000000000000000000000000000000000000000000P
P0000000000000000000000000000000000000000000000P
P0000000000000000000C00000000000000000000000000P
P0000000000000000000PPPPPPPP0000000000000000000P
P0000000000000000000000000000000000000000000000P
P0000000000000000PP0000000000PP0000000000000000P
P0000000000000000000000000000000000000000000000P
P00000000000000P0000000000000000P00000000000000P
P00000000000000P0000000000000000P00000000000000P
P0000000000000000000000000000000000000000000000P
000000000000PP00000000000000000000PP00000000000P
00000000000000000000000000000000000000000000000P
0000000000P00000000000000000000000000P000000000P
0000000000P00000000000000000000000000P000000000P
PPPPPPPPPPPPPPPPPPPPPPPPPPPPPPPPPPPPPPPPPPPPPPPP