PPPPPPPPPPPPPPPPPPSSS00000PPPPPPPPPPPPPPPPPPPPPP
00000000000000000P00000000P000000000000000000000
00000000000000000P00000000P000000000000000000000
00000000000000000P00000000P000000000000000000000
00000000000000000PSSSS000SP000000000000000000000
00000000000000000P00000000P000000000000000000000
00000000000000000P00000000P000000000000000000000
00000000000000000P00000000P000000000000000000000
00000000000000000PSSSSS000P000000000000000000000
00000000000000000P00000000P000000000000000000000
00000000000000000P00000000P000000000000000000000
00000000000000000P00000000P000000000000000000000
00000000000000000PSSSSSS00P000000000000000000000
00000000000000000P00000000P000000000000000000000
00000000000000000P00000000P000000000000000000000
00000000000000000PSSSS000SP000000000000000000000
00000000000000000P00000000P000000000000000000000
00000000000000000P00000000P000000000000000000000
00000000000000000PSSS000SSP000000000000000000000
00000000000000000P00000000P000000000000000000000
00000000000000000P00000000P000000000000000000000
00000000000000000PSS000SSSP000000000000000000000
00000000000000000P00000000P000000000000000000000
00000000000000000P00000000P000000000000000000000
00000000000000000PS000SSSSP000000000000000000000
00000000000000000P00000000P000000000000000000000
00000000000000000P00000000P000000000000000000000
00000000000000000P000SSSSSP000000000000000000000
00000000000000000P00000000P000000000000000000000
00000000000000000P00000000P000000000000000000000
00000000000000000P00SSSSSSP000000000000000000000
00000000000000000P00S00000P000000000000000000000
00000000000000000P00S00000P000000000000000000000
00000000000000000P00S00000P000000000000000000000
00000000000000000P00S00000P000000000000000000000
PPPPPPPPPPPPPPPPPP00S00000PPPPPPPPPPPPPPPPPPPPPP