PPPPPPPPPPPPPPPPPPPPPPPPPPPPPPPPPPPPPPPPPPPPPPPP
0000P0000000000000000000000000000000000000000000
0000P0000000000000000000000000000000000000000000
0000P0000000000000000000000000000000000000000000
0000P0000000000000000000000000000000000000000000
P000P00000000PPPPPPP0PPP0PPPPP0PPPPPP0PPPPPPPPPP
P000P0000000000000000000S00000S0000000000000000P
P000P000PP00000000000000P00000P0000000000000000P
P000P000SP00000000000000S00000S0000000000000000P
P000P000SP000PP00000000000000000000000000000000P
P000P000SP000PS00000000000000000000000000000000P
P000P000SP000PS00PP0000000000000000000000000000P
P000P000SP000PS0000000000SS0000SS00000000000000P
P000P000000000000000PPPPPPPPPPPPPPPPPS000000000P
P000P0000000000000000000000000000000000000C0000P
P000P000000000000000000000000000000000PPPPPP000P
P000P000000000000000000000000000000000000000000P
P000P000000000000000000000000000000000000000000P
P000P000000000000000000000000000000000000000000P
P00000000000000000000000000000000000000000000P0P
P0000000000000000000000000000000000000000000000P
P0000000000000000000000000000000000000000000000P
P000000000000000000000000000000SSS000SSS0000000P
P00000000000000000000000000SPPPPPPPPPPPPPPPP000P
P000000000000000000000000000S000000000000000000P
PS00000000000000000000000000S000000000000000000P
PPS00000000000000000000PPPPPS000000000000000000P
PPPS000000000000000000SSSSSSS000000000000000000P
PPPPS000000000PPPPP0000000000000000000000000000P
PPPPPS000C000SSSSSSS00000000000000SSS0000000000P
PPPPPPPPPPPPPPPPPPPPPPPPPPPPPPPPPPPPPPPPPPPPPPPP
000000000000000000000000000000000000000000000000
000000000000000000000000000000000000000000000000
000000000000000000000000000000000000000000000000
000000000000000000000000000000000000000000000000
PPPPPPPPPPPPPPPPPPPPPPPPPPPPPPPPPPPPPPPPPPPPPPPP
