PPPPPPPPPPPPPPPPPPPPPPPPPPPPPPPPPPPPPPPPPPPPPPPP
P0000000000000000000000000000000000000000000000P
P0000000000000000000000000000000000000000000000P
P0000000000000000000000000000000000000000000000P
P0000000000000000000000000000000000000000000000P
P000000000000000000000000000T0S000S00T000000000P
P0000000000000000000000T000000S000S000000000000P
P00000000000000000000000000000S0T0S000000000000P
P000000000000000000S0000000000S000S00000T000000P
P000000000000000000S0000000000S000S000000000T00P
P000000000000000000S0000000000S000S000000000000P
P0000000000S000T000S0000000000S000S000000000000P
P0000000000S0000000S0000000000S000S000000000000P
P0000000000S0000000S0000000000S000SSSSSSSSSS00TP
P0000000000S0000000S0000000000S000S000000000000P
P0000000000S0000000S0000000000S000S000000000000P
P0000000000S0000000S0000000000S000S000000000T00P
P0000000000S0000000S0000000000S000S000000000000P
P000000T000S0000000S0000000000S000S000000T00000P
P0000000000S0000000S0000000000S000S000000000000P
P0000000000S0000000S0000000000S000S000000000000P
P0S00000000S0000000S0000000000S000S000000000000P
P0S00000000S0000000S0000000000S000S0000T0000000P
P0SSSSSSSSSSSSSSSSSSSSSSSSSSSSSSSSSSSSSSSS000C0P
P0PPPPPPPPPPPPPPPPPPPPPPPPPPPPPPPPPPPPPPPPPPPP0P
P0S00S00000000000S00S00000000000S0S0000000P0000P
P0S00S00000000000S00S00000000000S0S0000000P0000P
P0S00S00000000000S00S00000000000S0S0000000P0P00P
P00000000000000000000000000000000000000000P00P0P
P00000000000000000000000000000000000000000PT00PP
P00000000000000000000000000000000000000000PS000P
P000000000000000000000000000000000000000000PT000
P0S00S00000000000S00S0000000000S00S000000000PS00
P0S00S00000000000S00S0000000000S00S0000000000P00
PTSTTS00000C00000STTS00000C0000STTS00000000000P0
PPPPPPPPPPPPPPPPPPPPPPPPPPPPPPPPPPPPPPPPPPP0000P