PPPPPPPPPPPPPPPPPPPPPPPPPPPPPPPPPP0000PPPPPPPPPP
P000000000000S0000S00000S00000S0000000P000000000
P0000000000000000000000000000000000000P000000000
P0000000000000000000000000000000000000P000000000
P0000000000S0000S0000S00000S00000S000CP000000000
P00SSPPPPPPPPPPPPPPPPPPPPPPPPPPPPPPPPPP00PPPPPPP
P0000P0PS0000000000SP0000000000000000PS0000000SP
P0000P0PS0000000000SP0000000000000000PS0000000SP
P0000P0PS0000000000SPPPPPPPPPPPPPPPPPPS0000000SP
P0000P0PS000000PS00SSSSSSSSSSSSSSSSSSSSPPPP000SP
P0000P0PS0000000S0000S000S000S000S00S00S00S000SP
PSS00P0PS0000000S0000S000S000S000S00S00S000000SP
P0000P0PS000PSSSS0P000000S000S000S00S00S00000PSP
P0000P0PS0000000S00000000S000S000S00S00S00000SSP
P0000PPPS0000000S000000000000S000S00S00000000SSP
P0000PSSSP000000S0000P0000000S000S00S00000P00SSP
P0000P0000000000S0000S0000000S000S00S00000S00SSP
P00SSP0000000000S0000000000000000S00000000S00SSP
P0000PSSSSSSP000S0PSSSSSSP0000000S00000P00S00SSP
P0000PS000000000S0PPPPPPPP0000000S00000S00S00SSP
P0000PS000000000S0000000000000000000000S00S00SSP
P0000PS00000000PSSSSSSSSSSSSSP000000P00S00S00SSP
P0000PS00000000PPPPPPPPPPPPPPP000000S00S00S00SSP
PSS00PS00000000000000000000000000000S00S00S00SSP
P0000PS00000PSSSSSSSSSSSSSSSSSSSSP00S00S00S00SSP
P0000PS00000PPPPPPPPPPPPPPPPPPPPPP00S00S00S00SSP
P0000PS000SSSSSSSSSSSSSSSSSSSSSSSSSSSSSSSSSSSSSP
P0000PS00PPPPPPPPPPPPPPPPPPPPPPPPPPPPPPPPPPPPPPP
P0000PS00000S000000000S000000000S00000000000000P
P00SSPS0000000000000000000000000000000000000000P
P0000PS0C00000PPPPPPP000PPPPPPP000PPPPPPP000000P
P0000PPPPPPPPPP00000PPPPP00000PPPPP00000PPPPPP0P
P0000000000000000000000000000000000000000000000P
P0C00000000000000000000000000000000000000000000P
P0000000000000000S000000000S000000000S000000000P
PPPPPPPPPPPPPPPPSSSPPPPPPPSSSPPPPPPPSSSPPPPPPPPP